LAYER
07 05
03,03,03,03,03,03,03,
03,03,03,03,03,03,03,
03,03,03,03,03,03,03,
03,03,03,03,03,03,03,
03,03,03,03,03,03,03,
LAYER
07 05
04,04,04,04,04,04,04,
04,00,00,00,00,00,04,
04,00,01,00,02,00,04,
04,00,00,00,00,00,04,
04,04,04,04,04,04,04,